111111111111111111111111111111
100000000010000000000000001001
101111000011111111000000001001
100001000010000000000000001001
100001110000011111001111111001
100000010001110001000000000001
100000010000010001001001000111
100000111110000100001001000001
100000000000000100000001000001
111111111111111111111111111111